-
222222222222222222222222222222
233130000300410000003441134112
210000000100110000000000000012
210000000000040000000000000012
210000000000030104410000000012
210000000000000400000000000342
210000000000000104100000114102
210000000000000001100000111102
200000000000000000000000111002
200000000000000000004100111002
200000000000000000011300411102
200010000000000000011400011402
200040000000000001000000003102
200010000000001401000000000002
200010000000001300000000000002
200010000000000000000000000002
210034100000000000000000000002
240011000000000000003400010002
210011004000011400001100031002
210013003001000100001100011002
210014343001001000000000000002
210000000001001000000000000002
230000000001001000000100000002
200000000003041000000300311002
200000000001011100000313114002
200000000001000000000000000002
200000000001144110000000000002
200000000000000000000000000002
200000000000000000000000000002
222222222222222222222222222222
